1111111111111111111111111111
1P00000001110100000000000001
10110010110101100101100X1101
10100C0C00000111001000000101
1010110010110110111011010101
10001000X00001000000X1100101
1010110010000C0X111111110101
100010000010010000100000C0C1
101011111001111011111CX10X01
1010100000000100000000110001
1011111011X10110011100101101
1C0000000101C0000X01001000E1
1111111111111111111111111111